type octile
height 100
width 100
map
TTTTTTTTTTTTTTTTTTTTTTTTTTTTTTTTTTTTTTTTTTTTTTTTTTTTTTTTTTTTTTTTTTTTTTTTTTTTTTTTTTTTTTTTTTTTTTTTTTT
T.................................................................................................T
T.................................................................................................T
T...............TTTTT.............................................TTTTTTTTTT......................T
T.............TTTTTTTT........................................TTTTTTTTTTTTTTTTT...................T
T...........TTTTTTTTTTT....................................TTTTTTTTTTTTTTTTTTTTTT.................T
T.........TTTTTTTTTTTTTT..................................TTTTTTTTTTTTTTTTTTTTTTTT................T
T..........TTTTTTTTTTTTTT................................TTTTTTTTTTTTTTTTTTTTTTTTT................T
T...........TTTTTTTTTTTTTTT..............................TTTTTTTTTTTTTTTTTTTTTTTT.................T
T............TTTTTTTTTTTTTTT............................TTTTTTTTTTTTTTTTTTTTTTT...................T
T.............TTTTTTTTTTTTTTTT..........................TTTTTTTTTTTTTTTTTTTT......................T
T..............TTTTTTTTTTTTTTTT..........................TTTTTTTTTTTTTTTTT........................T
T...............TTTTTTTTTTTTTTTTT........................TTTTTTTTTTTTTTT..........................T
T................TTTTTTTTTTTTTTTTT........................TTTTTTTTTTTTTT..........................T
T.................TTTTTTTTTTTTTTTTT.......................TTTTTTTTTTTTT...........................T
T..................TTTTTTTTTTTTTTTTT.......................TTTTTTTTTT.............................T
T...................TTTTTTTTTTTTTTTTTT......................TTTTTTTT..............................T
T....................TTTTTTTTTTTTTTTTTT......................TTTTT................................T
T.....................TTTTTTTTTTTTTTTTTT..........................................................T
T.....................TTTTTTTTTTTTTTTTT................................................TTTTT......T
T.....................TTTTTTTTTTTTTTTT..............................................TTTTTTTT......T
T.....................TTTTTTTTTTTTTTT.............................................TTTTTTTTTTT.....T
T.....................TTTTTTTTTTTTTT............................................TTTTTTTTTTTTT.....T
T....................TTTTTTTTTTTTTT...........................................TTTTTTTTTTTTTTTT....T
T...................TTTTTTTTTTTTTT...........................................TTTTTTTTTTTTTTTTT....T
T...................TTTTTTTTTTTTT...........................................TTTTTTTTTTTTTTTTT.....T
T..................TTTTTTTTTTTTTTT...........................................TTTTTTTTTTTTTTTT.....T
T.................TTTTTTTTTTTTTTTTT...........................................TTTTTTTTTTTTTT......T
T................TTTTTTTTTTTTTTTTTTTTTTTTTTTTT.................................TTTTTTTTTTTTT......T
T............TTTTTTTTTTTTTTTTTTTTTTTTTTTTTTTTTTTTTTTT...........................TTTTTTTTTTT.......T
T.......TTTTTTTTTTTTTTTTTTTTTTTTTTTTTTTTTTTTTTTTTTTTTTTTTTT....................TTTTTTTTTTTT.......T
T.....TTTTTTTTTTTTTTTTTTTTTTTTTTTTTTTTTTTTTTTTTTTTTTTTTTTT...................TTTTTTTTTTTTTTT......T
T......TTTTTTTTTTTTTTTTTTTTTTTTTTTTTTTTTTTTTTTTTTTTTT......................TTTTTTTTTTTTTTTTT......T
T.......TTTTTTTTTTTTTTTTTTTTTTTTTTTTTTTTTTTTTTTTT........................TTTTTTTTTTTTTTTTTTTT.....T
T.........TTTTTTTTTTTTTTTTTTTTTTTTTTTTTTT..............................TTTTTTTTTTTTTTTTTTTTTT.....T
T....................................................................TTTTTTTTTTTTTTTTTTTTTTTTT....T
T..................................................................TTTTTTTTTTTTTTTTTTTTTTTTTTT....T
T................................................................TTTTTTTTTTTTTTTTTTTTTTTTTTTTTT...T
T..............................................................TTTTTTTTTTTTTTTTTTTTTTTTTTTTTTTT...T
T.............................................................TTTTTTTTTTTTTTTTTTTTTTTTTTTTTTTTTT..T
T..............................................................TTTTTTTTTTTTTTTTTTTTTTTTTTTTTTTTT..T
T................................................................TTTTTTTTTTTTTTTTTTTTTTTTTTTTTTT..T
T..................................................................TTTTTTTTTTTTTTTTTTTTTTTTTTTTTT.T
T....................................................................TTTTTTTTTTTTTTTTTTTTTTTTTTTT.T
T......................................................................TTTTTTTTTTTTTTTTTTTTTTTTTT.T
T........................................................................TTTTTTTTTTTTTTTTTTTTTTTT.T
T.........................................................................TTTTTTTTTTTTTTTTTTTTTT..T
T..........................................................................TTTTTTTTTTTTTTTTTTTTT..T
T...........................................................................TTTTTTTTTTTTTTTTTTT...T
T...........................................................................TTTTTTTTTTTTTTTTTTT...T
T............................................................................TTTTTTTTTTTTTTTTT....T
T............................................................................TTTTTTTTTTTTTTTTT....T
T.............................................................................TTTTTTTTTTTTTTT.....T
T...........................TTTTTTTTTTTTTTTTTTTTTTTTTTTTTTT...................TTTTTTTTTTTTTTT.....T
T.......................TTTTTTTTTTTTTTTTTTTTTTTTTTTTTTTTTTTTT..................TTTTTTTTTTTTT......T
T...................TTTTTTTTTTTTTTTTTTTTTTTTTTTTTTTTTTTTTTTTTTTT...............TTTTTTTTTTTTT......T
T...................TTTTTTTTTTTTTTTTTTTTTTTTTTTTTTTTTTTTTTTTTTTTTT..............TTTTTTTTTTT.......T
T.................TTTTTTTTTTTTTTTTTTTTTTTTTTTTTTTTTTTTTTTTTTTTTTTT..............TTTTTTTTTTT.......T
T.................TTTTTTTTTTTTTTTTTTTTTTTTTTTTTTTTTTTTTTTTTTTTTTTTT...............................T
T.................TTTTTTTTTTTTTTTTTTTTTTTTTTTTTTTTTTTTTTTTTTTTTTTT................................T
T..................TTTTTTTTTTTTTTTTTTTTTTTTTTTTTTTTTTTTTT.........................................T
T..................TTTTTTTTTTTTTTTTTTTTTTTTTTTTTTTTTTTTTT.........................................T
T....................TTTTTTTTTTTTTTTTTTTTTTTTTTTTTTTTTTT..........................................T
T......................TTTTTTTTTTTTTTTTTTTTTTTTTTTTTTTT...........................................T
T.......................TTTTTTTTTTTTTTTTTTTTTTTTTTTT..............................................T
T.......................TTTTTTTTTTTTTTTTTTTTTTT...................................................T
T.......................TTTTTTTTTTTTTTTTTTTT......................................................T
T.......................TTTTTTTTTTTTTTTTTTTT......................................................T
T........................TTTTTTTTTTTTT............................................................T
T...........................TTTTTTTTTT............................................................T
T.................................................................................................T
T.....................................................................................TTTT........T
T....................................................................................TTTTTT.......T
T..................................................................................TTTTTTTTT......T
T...........................................................TT..................TTTTTTTTTTTTT.....T
T..........................................................TTTT................TTTTTTTTTTTTTTTT...T
T.........................................................TTTTTT.............TTTTTTTTTTTTTTTTTTT..T
T........................................................TTTTTTTTTTTTTTTTTTTTTTTTTTTTTTTTTTTT.....T
T.......................................................TTTTTTTTTTTTTTTTTTTTTTTTTTTTTTTTT.........T
T.....................................................TTTTTTTTTTTTTTTTTTTTTTTTTTTTTTTTTTTTT.......T
T......................................................TTTTTTTTTTTTTTTTTTTTTTTTTTTTTTTTTTTT.......T
T..........................................................TTTTTTTTTTTTTTTTTTTTTTTTTTTTTTTTTT.....T
T..................TTTTT..........................................TTTTTTTTTTTTTTTTTTTTTTTTTTT.....T
T............TTTTTTTTTTTTT............................................TTTTTTTTTTTTTTTTTTTTTTTT....T
T...........TTTTTTTTTTTTTTTT...........................................TTTTTTTTTTTTTTTTTTTTTTT....T
T...........TTTTTTTTTTTTTTTTTTTT...........................................TTTTTTTTTTTTTTTTTTTT...T
T..........TTTTTTTTTTTTTTTTTTTT.............................................TTTTTTTTTTTTTTTTTTTT..T
T..........TTTTTTTTTTTTTTTTTT................................................TTTTTTTTTTTTTT.......T
T............TTTTTTTTTTTTTTT..................................................TTTTTTTTTTTT........T
T.............TTTTTTTTTTTTT.....................................................TTTTTTTT..........T
T.............TTTTTTTTTTTTT......................................................TTTTTTTTT........T
T...............TTTTTTTTT.........................................................TTTTTTTTT.......T
T.................TTTTTT..........................................................................T
T.................................................................................................T
T.................................................................................................T
T.................................................................................................T
T.................................................................................................T
T.................................................................................................T
T.................................................................................................T
TTTTTTTTTTTTTTTTTTTTTTTTTTTTTTTTTTTTTTTTTTTTTTTTTTTTTTTTTTTTTTTTTTTTTTTTTTTTTTTTTTTTTTTTTTTTTTTTTTT
