type octile
height 100
width 100
map
TTTTTTTTTTTTTTTTTTTTTTTTTTTTTTTTTTTTTTTTTTTTTTTTTTTTTTTTTTTTTTTTTTTTTTTTTTTTTTTTTTTTTTTTTTTTTTTTTTTT
T...................................T....................T....................T....................T
T...................................T....................T....................T....................T
T...................................T....................T....................T....................T
T...................................T....................T....................T....................T
T...................................T....................T....................T....................T
T...................................T....................T....................T....................T
T...................................T....................T....................T....................T
T.......TTTTTTTT......TTTTTTTT......T......TTTTTTTTTTTTTTTTTTTTTTTTTTTTT......T......T......T......T
T.......T....................T......T......T...........................T.............T......T......T
T.......T....................T......T......T...........................T.............T......T......T
T.......T....................T......T......T...........................T.............T......T......T
T.......T....................T......T......T...........................T.............T......T......T
T.......T....................T......T......T...........................T.............T......T......T
T.......T....................T......T......T...........................T.............T......T......T
T.......T......TTTTTTTT......T......T......T......TTTTTTTT......TTTTTTTT.............T......T......T
T.......T......T.............T.............T......T......T....................T......T.............T
T.......T......T.............T.............T......T......T....................T......T.............T
T.......T......T.............T.............T......T......T....................T......T.............T
T.......T......T.............T.............T......T......T....................T......T.............T
T.......T......T.............T.............T......T......T....................T......T.............T
T.......T......T.............T.............T......T......T....................T......T.............T
T.......T......T......T......TTTTTTTT......T......T......TTTTTTTT......TTTTTTTT......TTTTTTTT......T
T.......T......T......T.............T.............T...........................T......T.............T
T.......T......T......T.............T.............T...........................T......T.............T
T.......T......T......T.............T.............T...........................T......T.............T
T.......T......T......T.............T.............T...........................T......T.............T
T.......T......T......T.............T.............T...........................T......T.............T
T.......T......T......T.............T.............T...........................T......T.............T
TTTTTTTTT......T......TTTTTTTTTTTTTTTTTTTTTT......TTTTTTTTTTTTTTTTTTTTTTTTTTTTT......T......T......T
T..............T....................T......T.........................................T......T......T
T..............T....................T......T.........................................T......T......T
T..............T....................T......T.........................................T......T......T
T..............T....................T......T.........................................T......T......T
T..............T....................T......T.........................................T......T......T
T..............T....................T......T.........................................T......T......T
T.......TTTTTTTTTTTTTTTTTTTTTT......T......TTTTTTTT......T......T......TTTTTTTT......TTTTTTTT......T
T...................................T.............T......T......T.............T......T.............T
T...................................T.............T......T......T.............T......T.............T
T...................................T.............T......T......T.............T......T.............T
T...................................T.............T......T......T.............T......T.............T
T...................................T.............T......T......T.............T......T.............T
T...................................T.............T......T......T.............T......T.............T
TTTTTTTTTTTTTTTTTTTTTTT.............T......T......TTTTTTTT......TTTTTTTT......T......T......TTTTTTTT
T.....................T....................T...........................T......T....................T
T.....................T....................T...........................T......T....................T
T.....................T....................T...........................T......T....................T
T.....................T....................T...........................T......T....................T
T.....................T....................T...........................T......T....................T
T.....................T....................T...........................T......T....................T
T......TTTTTTTT.......T......TTTTTTTT......T......T......TTTTTTTTTTTTTTT......T......TTTTTTTT......T
T.............T.......T......T......T......T......T...........................T......T.............T
T.............T.......T......T......T......T......T...........................T......T.............T
T.............T.......T......T......T......T......T...........................T......T.............T
T.............T.......T......T......T......T......T...........................T......T.............T
T.............T.......T......T......T......T......T...........................T......T.............T
T.............T.......T......T......T......T......T...........................T......T.............T
TTTTTTTT......T.......T......T......T......T......TTTTTTTT......TTTTTTTTTTTTTTT......T......TTTTTTTT
T......T......T............................T.............T...........................T.............T
T......T......T............................T.............T...........................T.............T
T......T......T............................T.............T...........................T.............T
T......T......T............................T.............T...........................T.............T
T......T......T............................T.............T...........................T.............T
T......T......T............................T.............T...........................T.............T
T......T......T.......TTTTTTTTTTTTTTT......TTTTTTTT......TTTTTTTTTTTTTTTTTTTTTT......T......T......T
T.............T.............T.....................T.........................................T......T
T.............T.............T.....................T.........................................T......T
T.............T.............T.....................T.........................................T......T
T.............T.............T.....................T.........................................T......T
T.............T.............T.....................T.........................................T......T
T.............T.............T.....................T.........................................T......T
TTTTTTTT......TTTTTTTTTTTTTTT.......TTTTTTTT......TTTTTTTT......TTTTTTTTTTTTTTTTTTTTTT......TTTTTTTT
T......T............................T......T...........................T...........................T
T......T............................T......T...........................T...........................T
T......T............................T......T...........................T...........................T
T......T............................T......T...........................T...........................T
T......T............................T......T...........................T...........................T
T......T............................T......T...........................T...........................T
T......T......TTTTTTTT.......TTTTTTTT......TTTTTTTTTTTTTTTTTTTTTT......T......TTTTTTTT......TTTTTTTT
T......T......T..............T.............T...........................T......T......T......T......T
T......T......T..............T.............T...........................T......T......T......T......T
T......T......T..............T.............T...........................T......T......T......T......T
T......T......T..............T.............T...........................T......T......T......T......T
T......T......T..............T.............T...........................T......T......T......T......T
T......T......T..............T.............T...........................T......T......T......T......T
T......T......T.......TTTTTTTT......T......TTTTTTTT......TTTTTTTTTTTTTTT......T......T......T......T
T.............T.......T.............T................................................T......T......T
T.............T.......T.............T................................................T......T......T
T.............T.......T.............T................................................T......T......T
T.............T.......T.............T................................................T......T......T
T.............T.......T.............T................................................T......T......T
T.............T.......T.............T................................................T......T......T
T......TTTTTTTT.......TTTTTTTTTTTTTTTTTTTTTTTTTTTTTTTTTTTTTTTTTTTTTTTTTTTTTTTTT......T......T......T
T.............T..........................................T...........................T.............T
T.............T..........................................T...........................T.............T
T.............T..........................................T...........................T.............T
T.............T..........................................T...........................T.............T
T.............T..........................................T...........................T.............T
T.............T..........................................T...........................T.............T
TTTTTTTTTTTTTTTTTTTTTTTTTTTTTTTTTTTTTTTTTTTTTTTTTTTTTTTTTTTTTTTTTTTTTTTTTTTTTTTTTTTTTTTTTTTTTTTTTTTT
