type octile
height 49
width 49
map
TTTTTTTTTTTTTTTTTTTTTTTTTTTTTTTTTTTTTTTTTTTTTTTTT
T...............................................T
T...............................................T
T..........TTTT.................................T
T..........TTTTTTTTT............................T
T..........TTTTTTTTT............................T
T...........TTTTTTTTT...........................T
T..........TTTTTTTTT............................T
T...............................................T
T..............................TTTTTTT..........T
T...............................TTTTTTT.........T
T..............................TTTTTTTTTTT......T
T.........................TTTTTTTTTTT...........T
T........................TTTTTTTTTT.............T
T...............................................T
T...............................................T
T...............................................T
T...............................................T
T...............................................T
T.......................TTTTTT..................T
T.....................TTTTTTTTT.................T
T...................TTTTTTTTTTT.................T
T...................TTTTTTTTTTTT................T
T...................TTTTTTTTTTTT................T
T....................TTTTTTTTTTT................T
T....................TTTTTTTTTT.................T
T.....................TTTTTTT...................T
T...............................................T
T...............................................T
T...............................................T
T...............................................T
T...............................................T
T........TTTTTTTTTTTT...........................T
T......TTTTTTTTTTTTTTTTT........................T
T.......TTTTTTTTTTTTTTT.........................T
T.........TTTTTTTTTTT...........................T
T.............TTTTTTTT..........................T
T...............................................T
T...............................................T
T........................TTTTTTTTTTTT...........T
T....................TTTTTTTTTTTTTTTTT..........T
T.....................TTTTTTTTTTTTTTT...........T
T.......................TTTTTTTTTTTT............T
T........................TTTTTTTTTT.............T
T.........................TTTTTTT...............T
T...............................................T
T...............................................T
T...............................................T
TTTTTTTTTTTTTTTTTTTTTTTTTTTTTTTTTTTTTTTTTTTTTTTTT
