type octile
height 13
width 20
map
TTTTTTTTTTTTTTTTTTTT
T..................T
T.TT.T.TT..TT.T.TT.T
T.T..............T.T
T.T.TT.TT..TT.TT.T.T
T.............T....T
T.T....TTTT.T.T..T.T
T.T....T....T.T..T.T
T.T....T.TTTT.T..T.T
T.T...........T..T.T
T.TT.T..TTTT..T.TT.T
T....T........T....T
TTTTTTTTTTTTTTTTTTTT
