type octile
height 9
width 25
map
TTTTTTTTTTTTTTTTTTTTTTTTT
T.......................T
T.......................T
T.......................T
T.......................T
T.......................T
T.......................T
T.......................T
TTTTTTTTTTTTTTTTTTTTTTTTT